#####
#   #####
# # #   #
# $   $ #
#..#$#$##
#.@$   #
#..  ###
######