#####
#   #
# $@# ###
# $$# #.#
### ###.#
 ##    .#
 #   #  #
 #   ####
 #####