######
#    #
# $$$##
#  #..###
##  ..$ #
 #@     #
 ########