 ######
 #    ##
##.##$ #
# ..$  #
#  #$  #
#  @ ###
######